WWWWWWWWWWWWWWWWWW
W................W
W....T......T....W
W................W
W................W
W.......P........W
W........P.......W
W........P.......W
W.......P........W
W....X.......Y...W
W....X.......Y...W
W....X...T...Y...W
W.......TTT......W
W................W
WWWWWWWWWWWWWWWWWW
